#Example: Large parts of Africa and south east Asia
tropical = {
	5237 5238 6857 6858 6859 6861 6860 6862 6863 6856 6855 6864 6865 6866 6867 6868 6869 6870 6871 7390 7389 7388 7387 7391
	6944 6945 6946 6947 7285 7399 7400 7398 7397 7396 7395 7394 7393 7392 7618 7619 7624 7617 7616 7613 7611 7575 7625 7626
	7627 7628 7620 7621 7623 7622 7612 7609 7610 7607 7606 7608 7605 7577 7576 7386 7252 7253 7254 7255 7256 7235 7234 7233
	7232 7257 7259 7258 7260 7231 7261 7262 7263 7265 7267 7266 7272 7331 7332 7333 7337 7340 7338 7339 7341 7343 7352 7353
	7366 7367 7368 7354 7356 7357 7365 7378 5651 5662 5675 5641
	#HASMAL below
	8846  8845  8844  8843  8842  8841  8840  8839  8838  8837  8836  8835  8834  8833  8832  8831  8830  8829  8828  8827  8826  8825  8824  8823  8822  8821  8820  8819  8818  8817  8816  8815  8814  8813  8812  8811  8810  8809  8808  8807  8806  8805  8804  8803  8802  8801  8800  8799  8798  8797  8796  8795  8794  8793  8792  8791  8790  8789  8788  8787  8786  8785  8784  8783  8782  8781  8780  8779  8778  8777  8776  8775  8774  8773  8772  8771  8770  8769  8768  8767  8766  8765  8764  8763  8762  8761  8760  8759  8758  8757  8756  8755  8754  8753  8752  8751  8750  8749  8748  8747  8746  8745  8744  8743  8742  8741  8740  8739  8738  8737  8736  8735  8734  8733  8732  8731  8730  8729  8728  8727  8726  8725  8724  8723  8722  8721  8720  8719  8718  8717  8716  8715  8714  8713  8712  8711  8710  8709  8708  8707  8706  8705  8704  8703  8702  8701  8700  8699  8698  8697  8696  8695  8694  8693  8692  8691  8690  8689  8688  8687  8686  8685  8684  8683  8682  8681  8680  8679  8678  8677  8676  8675  8674  8673  8672  8671  8670  8669  8668  8667  8666  8665  8664  8663  8662  8661  8660  8659  8658  8657  8656  8655  8654  8653  8652  8651  8650  8649  8648  8647  8646  8645  8644  8643  8642  8641  8640  8639  8638  8637  8636  8635  8634  8633  8632  8631  8630  8629  8628  8627  8626  8625  8624  8623  8622  8621  8620  8619  8618  8617  8616  8615  8614  8613  8612  8611  8610  8609  8608  8607  8606  8605  8604  8603  8602  8601  8600  8599  8598  8597  8596  8595  8594  8593  8592  8591  8590  8589  8588  8587  8586  8585  8584  8583  8582  8581  8580  8579  8578  8577  8576  8575  8574  8573  8572  8571  8570  8569  8568  8567  8566  8565  8564  8563  8562  8561  8560  8559  8558  8557  8556  8555  8554  8553  8552  8551  8550  8549  8548  8547  8546  8545  8544  8543  8542  8541  8540  8539  8538  8537  8536  8535  8534  8533  8532  8531  8530  8529  8528  8527  8526  8525  8524  8523  8522  8521  8520  8519  8518  8517  8516  8515  8514  8513  8512  8511  8510  8509  8508  8507  8506  8505  8504  8503  8502  8501  8500  8499  8498  8497  8496  8495  8494  8493  8492  8490  8489  8488  8487  8486  8485  8484  8483  8482  8481  8480  8479  8478  8477  8476  8475  8474  8473  8472  8471  8470  8469  8468  8467
}

arid = {
	5150 5812 5813 5814 5815 5146 5556 5557 5609 5647 5111 5112 5049 5055 5098 5151 5819 5172 5818 5170 5168 5165 5633 5631
	6916 6915 6913 6911 6910 6907 6906 6903 6901 6887 6885 6886 6022 6888 6898 6897 6899 6894 6896 6882 6880 6877 6878 6884
	6874 6873 6872 5891 5887 5888 5826 5907 5894 5893 5892 6879 6881 5900 6875 6876 5901 5902 5903 5904 6034 6000 5999 8050
	6912 5895 7302 7316 7303 7350 7349 7348 7248 7247 7245 7238 7237 7236 8049 8048 8047 8046 8045 8044 7972 7952 7953 7954
	7955 7956 7957 7958 7959 7960 7962 7971 7970 7969 7968 7967 7965 7966 7964 7963 7961 7984 7985 7986 7987 7988 7951 7973
	7974 7975 7976 7977 7978 8001 7981 8027 8026 7982 7983 8022 8024 8023 8025 8176 8273 8271 8005 7347 7995 7997 7998 7999
	8000 8193 8209 8100 8115 8116 8138 8137 8135 8133 8095 8093 8090 8062 8036 8034 8029 8028 8032 7241 8065 8066 8074 8072
	8060 7994 7993 7991 7992 7989 7990 8037 8038 8039 8040 8041 8042 8043 8080 7016
}

arctic = {
	6466 6464 6462 6461 6458 6457 6326 6324 6325 6327 6321 6318 6342 6509 6514 6511 6515 6516 6512 6492 6491 6467 6468 6469
	6063 6064 6463 6330 6312 6317 6311 6470 6471 6472 6478 6525 6524 6523 6496 6489 6520 6519 6490 6500 6508 6518 6517 6504
	6505 6503 6499 6502 6498 6497 6501 6065 6066 6507 6506 6460 6459 6465 6329 6331 6332 6333 6320 6332 6323 6322
}

#Example: Most of Europe north of med.
mild_winter = {
	5260 5261 5266 5262 5268 5267 5258 5257 5236 5279 5265 5271 5273 5282 5278 5302 5301 5311 5308 5339 5338 5342 5343 5344 5357 5353 5803 5802 5569 5570 5717 6454
	5568 5804 5806 5809 5800 5799 5707 5798 5571 5666 5706 5705 5698 5697 5608 5607 5699 5693 5287 5428 5823 5425 5233 5788 5234 5232 5572 5574 5576 5797 5795 5291 5691 5692
	5604 5606 5521 5535 5536 5519 5520 5522 5525 5527 5534 5533 5532 5531 5530 5541 5537 5605 5540 5538 5539 5728 5617 5627 5727 5729 5730 5731 5733 5732 5734 5735 5661 5737
	5736 5808 5807 5796 5696 5293 5700 5704 5703 5701 5355 5356 5351 5358 5349 5348 5345 5340 5346 5347 5300 5297 5298 5283 5286 5284 5288 5341 5313 5312 5309 5824 6203 6836
	5299 5285 5289 5294 5310 5295 5296 5678 6117 6451 6853 6450 6441 6439 6433 6432 6419 6420 6428 6244 6242 6243 6240 5884 5664 5061 6191 6190 6187 6186 6840
	6185 6184 6194 6188 6189 6195 6181 6179 6180 6178 6177 6176 6175 6174 6173 6368 6369 6375 6182 6183 6409 6193 6192 6412 6170 6169 6171 6168 6172 6387 6386 6383 6384 6385
	6394 6396 6395 5695 6390 6391 6389 6393 6415 6414 6413 6392 6438 6445 6446 6437 6440 6442 6447 6448 6449 6444 6376 6374 6377 6378 6379 6380 6381 6344 6382 6388 6397 6400
	6401 6418 6416 6417 6423 6422 6424 6429 6431 6430 6452 6408 6411 6410 6406 6407 6405 6404 6343 6436 6435 6403 6426 6402 6425 6399 6398 6700 6702 6704 6712 6842 6841
	6835 6833 6834 6826 6825 6824 6829 6830 6827 6828 6823 6847 6848 6849 6851 6850 6822 6818 6821 6816 6815 6812 6814 6846 6852 6845 6844 6803 6799 6800 6802 6801 5947 5948
	6817 6843 6804 6806 6807 6808 6699 6698 6703 6705 6706 6714 6707 6708 6713 6715 6710 6038 6805 6789 6792 6791 6790 6794 6793 5825 5867 5866 5847 5870 6112 6062 6120 5958
	5865 5874 5880 5878 5858 5869 5883 5838 5914 6057 5915 6076 5916 6078 6079 6082 6081 5932 5971 5868 5970 5968 5967 5957 5956 5955 5959 5954 5953 5952 5946 5945 5944 5934
	5935 5938 5937 5936 6097 6096 6121 6105 6104 6106 6107 6103 6102 6108 6111 6110 6061 7006 7008 7198 7005
}

#Example: Inland Europe & Scandinavia
normal_winter = {
	5744 5745 5742 5740 5739 5738 5741 5669 5352 5350 5528 5719 5711 5712 5709 5708 5718 5716 5713 5720 5721 5724 5725 5722 5726 5655 5658 5637 5596 6214 6196 6197 6198
	5784 5618 5190 5500 5626 5638 6453 6810 6125 5985 6820 6819 6813 6212 6202 6201 6199 6200 6241 6239 6221 6204 6205 6237 6238 6236 6234 6235 6206 6207 6208 6213 6219
	6220 6218 6215 6216 6223 6217 6224 6211 6210 6209 6226 6227 6229 6225 6222 6233 6231 6232 6230 6228 6259 6258 6260 6262 6263 6261 6264 6256 6257 6255 6269 6268 6266
	6270 6271 6253 6265 6254 6267 6249 6250 6251 6351 6353 6354 6355 6357 6359 6360 6358 6361 6367 6356 6366 6370 6159 6365 6363 6362 6364 6371 6372 6373 6697
	6709 6711 6730 6732 6734 6738 6741 6740 6762 6764 6769 6781 6779 6784 6788 6040 6245 6696 6246 6695 6694 6247 6693 6692 6248 6691 6731 6690 6735 6736 6739 6737 6689
	5989 6608 6606 6605 6607 6609 6610 6611 6612 6615 6614 6613 6006 6047 6051 6629 6625 6624 6623 6621 6626 6622 6631 6627 6757 6759 6758 6765 6767 6761 6760 6749 6673
	6672 6782 6780 6667 6668 6766 6768 6671 6670 6655 6669 6778 6777 6787 6666 6665 6664 6661 6656 6662 6657 6632 6630 6659 6641 6642 6660 6663 5911 5913 6075 6058 6077
	5908 5929 6074 5928 5927 5930 6080 5926 5923 5922 6089 6092 6093 6094 5933 6095 6099 6098 6658 6786 6785 6783 6770 6776 6720 6719 6718 6721 6722 6727 6728 6724 6725
	6726 6742 6729 6748 6745 6743 6763 6744 6773 6774 6854 6797 6796 6798 6795 6775 6771 6772 6716 6717 6733 6723 5889 8458 6682 8859
}

#Example: Russia & Lappland
severe_winter = {
	4942 5524 5523 5526 5529 6350 6349 6455 6167 6165 6164 6163 6162 6160 5213 6456 6457 6458 6459 6461 6460 6463 6462 6464 6465 6466 6338 6336 6337 6339 6340 6341 6327
	6324 6326 6330 6329 6325 6331 6332 6333 6335 6334 6328 6323 6322 6321 6320 6318 6319 6316 6314 6313 6309 6305 6304 6310 6315 6317 6306 6308 6311 6312 6342 6307 6303 6299
	6301 6297 6300 6302 6298 6296 6295 6292 6293 6294 6289 6288 6287 6291 6290 6286 6285 6284 6283 6282 6274 6276 6275 6281 6280 6277 6278 6279 6073 6059 5910 6072 6751 5715
	6071 5925 5924 5921 5920 5919 5918 5917 6070 6069 6068 5909 6067 6060 6065 6066 6064 6063 6088 6087 6091 6090 6086 6085 6084 6083 6166 6161 6272 6273 6252 6686 6685 6684
	6687 6683 6681 6680 6678 6679 6676 6504 6503 6505 6507 6499 6498 6502 6497 6501 6506 6518 6517 6516 6512 6514 6509 6511 6515 6519 6520 6525 6524 6523 6526 6527 6522
	6521 6508 6500 6491 6492 6470 6469 6468 6467 6471 6472 6473 6477 6604 6603 6602 6601 6616 6617 6619 6618 6587 6586 6582 6597 6596 6589 6588 6579 6569 6584 6583 6585 6536
	6546 6547 6548 6549 6633 6646 6647 6648 6650 6649 6654 6643 6644 6645 6640 6639 6653 6652 6651 6674 6675 6677 6559 6558 6568 6566 6565 6564 6598 6620 6595 6628 6594 6593
	6592 6591 6590 6637 6638 6636 6635 6634 6600 6599 6571 6578 6580 6572 6570 6581 6573 6574 6576 6577 6575 6483 6482 6474 6475 6476 6481 6480 6479 6478 6485 6484 6486 6348
	6347 6346 6811 6809 6688 6755 6756 6754 6753 6752 6490 6496 6489 6495 6488 6487 6493 6494 6531 6532 6533 6535 6538 6534 6528 6541 6540 6539 6551 6550 6545 6553 6554 6542
	6544 6543 6555 6556 6557 6561 6562 6563 6530 6750 5714 6352 5634 8853
}

impassable = {
	4942 4943 4944 4945 4946 4947 4948 4949 4950 4951 4952 4953 4954 4955 4956 4957 4958 5210 5211 5212 5213 5231 5232 5233 5234 5587 5588 5589 5638 5788 5430 5585 5586 5426
	5245 5246 5247 5248 5249 5508 5554 5890 5931 5908 6058 6059 6060 6061 6062 6159 6160 6161 6162 6163 6164 6165 6166 6167 6344 6343 6434 6349 6350 6348 6347 6346 6454 6453
	6455 6456 7002 7003 7004 7005 7006 7007 7008 7009 7010 7011 7012 7013 7014 7015 7198 7225 7226 7227 7228 7224 8453 8437 8438 8442 8441 8436 8435 8439 8440 8434 8432 8433
	8429 8422 8423 8430 8431 8449 8428 8427 8426 8424 8425 8421 8420 8419 8418 8451 8452 8450 8457 8445 8448 8447 8444 8446 8443 5250 5251 8459 8460 8461 8462 8463 8464 8465
	8466 8491 8847 8853 8866
}

mild_monsoon = {
	6861 6862 6866 6868 6869 6870 6856
}

normal_monsoon = {
	5237 5238 6865 6864 6859 6860
}

severe_monsoon = {
	6857 6858
}

equator_y_on_province_image = 656
