#Example: Large parts of Africa and south east Asia
tropical = {
	5237 5238
}

arid = {
	5150 5812 5813 5814 5815 5146 5556 5557 5609 5647 5111 5112 5049 5055 5098 5151 5819 5172 5818 5170 5168 5165 5633
}

arctic = {
}

#Example: Most of Europe north of med.
mild_winter = {
	5695 5260 5261 5266 5262 5268 5267 5258 5257 5236 5279 5265 5271 5273 5282 5278 5302 5301 5311 5308 5339 5338 5342 5343 5344 5357 5353 5803 5802 5569 5570 5717 5210 5213
	5568 5804 5806 5809 5800 5799 5707 5798 5571 5666 5706 5705 5698 5697 5608 5607 5699 5693 5287 5428 5823 5425 5233 5788 5234 5232 5572 5574 5576 5797 5795 5291 5691 5692
	5604 5606 5521 5535 5536 5519 5520 5522 5525 5527 5534 5533 5532 5531 5530 5541 5537 5605 5540 5538 5539 5728 5617 5627 5727 5729 5730 5731 5733 5732 5734 5735 5661 5737
	5736 5808 5807 5796 5696 5293 5508 5489 5700 5704 5703 5701 5355 5356 5351 5358 5349 5348 5345 5340 5346 5347 5300 5297 5298 5283 5286 5284 5288 5341 5313 5312 5309 5824
	5299 5285 5289 5294 5310 5295 5296 5678 5491
}

#Example: Inland Europe & Scandinavia
normal_winter = {
	4944 4943 5744 5745 5742 5740 5739 5738 5741 5669 5352 5350 5528 5719 5711 5714 5712 5709 5708 5718 5715 5716 5634 5713 5720 5721 5724 5725 5722 5726 5655 5658 5637 5596
	5784 5618 5190 5500 5626 5638
}

#Example: Russia & Lappland
severe_winter = {
	4942 4948 5524 5523 5526 5529
}

impassable = {
	4942 4943 4944 4945 4946 4947 4948 4949 4950 4951 4952 4953 4954 4955 4956 4957 4958 5210 5211 5212 5213 5231 5232 5233 5234 5587 5588 5589 5638 5788 5430 5585 5586 5426
	5245 5246 5247 5248 5249 5508 5554 5890 5931 5908
}

mild_monsoon = {
}

normal_monsoon = {
	5237 5238
}

severe_monsoon = {
}

equator_y_on_province_image = 656
