#Example: Large parts of Africa and south east Asia
tropical = {
	5237 5238 6857 6858 6859 6861 6860 6862 6863 6856 6855 6864 6865 6866 6867 6868 6869 6870 6871
	6944 6945 6946 6947
}

arid = {
	5150 5812 5813 5814 5815 5146 5556 5557 5609 5647 5111 5112 5049 5055 5098 5151 5819 5172 5818 5170 5168 5165 5633 5631
	6916 6915 6913 6911 6910 6907 6906 6903 6901 6887 6885 6886 6022 6888 6898 6897 6899 6894 6896 6882 6880 6877 6878 6884
	6874 6873 6872 5891 5887 5888 5826 5907 5894 5893 5892 6879 6881 5900 6875 6876 5901 5902 5903 5904 6034 6001 6000 5999
	6912 5895
}

arctic = {
	6466 6464 6462 6461 6458 6457 6326 6324 6325 6327 6321 6318 6342 6509 6514 6511 6515 6516 6512 6492 6491 6467 6468 6469
	6063 6064
}

#Example: Most of Europe north of med.
mild_winter = {
	5695 5260 5261 5266 5262 5268 5267 5258 5257 5236 5279 5265 5271 5273 5282 5278 5302 5301 5311 5308 5339 5338 5342 5343 5344 5357 5353 5803 5802 5569 5570 5717 5210 6454
	5568 5804 5806 5809 5800 5799 5707 5798 5571 5666 5706 5705 5698 5697 5608 5607 5699 5693 5287 5428 5823 5425 5233 5788 5234 5232 5572 5574 5576 5797 5795 5291 5691 5692
	5604 5606 5521 5535 5536 5519 5520 5522 5525 5527 5534 5533 5532 5531 5530 5541 5537 5605 5540 5538 5539 5728 5617 5627 5727 5729 5730 5731 5733 5732 5734 5735 5661 5737
	5736 5808 5807 5796 5696 5293 5489 5700 5704 5703 5701 5355 5356 5351 5358 5349 5348 5345 5340 5346 5347 5300 5297 5298 5283 5286 5284 5288 5341 5313 5312 5309 5824
	5299 5285 5289 5294 5310 5295 5296 5678 5491
}

#Example: Inland Europe & Scandinavia
normal_winter = {
	5744 5745 5742 5740 5739 5738 5741 5669 5352 5350 5528 5719 5711 5714 5712 5709 5708 5718 5715 5716 5634 5713 5720 5721 5724 5725 5722 5726 5655 5658 5637 5596
	5784 5618 5190 5500 5626 5638 6453
}

#Example: Russia & Lappland
severe_winter = {
	4942 4948 5524 5523 5526 5529 6350 6349 6455 6167 6165 6164 6163 6162 6160 5213 6456
}

impassable = {
	4942 4943 4944 4945 4946 4947 4948 4949 4950 4951 4952 4953 4954 4955 4956 4957 4958 5210 5211 5212 5213 5231 5232 5233 5234 5587 5588 5589 5638 5788 5430 5585 5586 5426
	5245 5246 5247 5248 5249 5508 5554 5890 5931 5908 6058 6059 6060 6061 6062 6159 6160 6161 6162 6163 6164 6165 6166 6167 6344 6343 6434 6349 6350 6348 6347 6346 6454 6453
	6455 6456 7002 7003 7004 7005 7006 7007 7008 7009 7010 7011 7012 7013 7014 7015 7198 7225 7226 7227 7228
}

mild_monsoon = {
	6861 6862 6866 6868 6869 6870 6856
}

normal_monsoon = {
	5237 5238 6865 6864 6859 6860
}

severe_monsoon = {
	6857 6858
}

equator_y_on_province_image = 656
