europe = { 5823  5822  5820  5819  5818  5817  5816  5815  5814  5813  5812  5811  5792  5791  5790  5789  5788  5648  5787  5786  5652  5651  5650  5649  5647  5646  5645  5644  5643  5642  5641  5640  5639  5638  5636  5635  5634  5633  5632  5631  5630  5629  5627  5625  5620  5619  5617  5616  5615  5614  5613  5612  5611  5610  5609  5606  5605  5604  5603  5602  5600  5599  5598  5597  5595  5594  5593  5592  5591  5590  5589  5588  5587  5586  5585  5557  5556  5555 
	5468  5467  5466  5465  5464  5463  5462  5461  5460  5459  5458  5457  5456  5455  5454  5453  5452  5451  5450  5449  5448  5447  5446  5445  5444  5443  5442  5441  5440  5439  5438  5437  5436  5435  5434  5433  5432  5431  5430  5429  5428  5427  5426  5425  5424  5423  5422  5421  5420  5419  5418  5417  5416  5415  5414  5413  5412  5411  5410  5409  5408  5407  5406  5405  5404  5403  5402  5401  5400  5399  5398  5397  5396  5395  5394  5393  5392  5391  5390  5389  5388  5387  5386  5385  5384  5383  5382  5381  5380  5379  5378  5377  5376  5375  5374  5373  5372  5371  5370  5369  5368  5367  5366  5365  5364  5363  5362  5361  5360  5359
	5554  5553  5552  5551  5550  5549  5548  5547  5546  5545  5544  5543  5252  5251  5250  5249  5248  5247  5246  5245  5243  5242  5241  5240  5239  5238  5237  5236  5235  5234  5233  5232  5231  5230  5229  5228  5227  5226  5225  5224  5223  5222  5221  5220  5219  5218  5217  5216  5215  5214  5213  5212  5211  5210  5209 5209 5208  5207  5206  5205  5204  5202  5201  5200  5199  5198  5197  5196  5195  5194  5193  5192  5191  5189  5188  5187  5186  5185  5184  5183  5182  5181  5180  5179  5178  5177  5176  5175  5174  5173  5172  5171  5170  5169  5168  5167  5166  5165  5164  5163  5162  5161  5160  5162  5159  5158  5157  5156  5155  5154  5153  5152 
	5151  5150  5149  5148  5147  5146  5145  5144  5143  5142  5141  5140  5139  5138  5137  5136  5135  5134  5133  5132  5131  5130  5129  5128  5127  5126  5125  5124  5123  5122  5121  5120  5119  5118  5117  5116  5115  5114  5113  5112  5111  5110  5109  5108  5107  5106  5105  5104  5103  5102  5101  5100  5099  5098  5097  5096  5095  5094  5093  5092  5091  5090  5089  5088  5087  5086  5085  5084  5083  5082  5081  5080  5079  5078  5077  5076  5075  5074  5073  5072  5071  5070  5069  5068  5067  5066  5065  5064  5063  5062  5061  5060  5059  5058  5057  5056  5055  5054  5053  5052  5051  5050  5049  5048  5047  5046  5045  5044  5043  5042  5041  5040  5016  5015  5014  5013  5012  5011  5010  5009  5008  5007  5006  5005  5004  5003  5002  5001  5000  4999  4998  4997  4996  4995  4994  4993  4992  4991  4990  4989  4988  4987  4986  4985  4984  4983  4982  4981  4980  4979  4978  4977  4976  4975  4974  4973  4972  4971  4970  4969  4968  4967  4966  4965  4964  4963  4962  4961  4960  4959  4958  4957  4956  4955  4954  4953  4952  4951  4950  4949  4948  4947  4946  4945  4944  4943  4942  5148  5147  5146  5145  5144  5143  5142  5141  5140  5139  5138  5137  5136  5135  5134  5133  5132  5131  5130  5129  5128  5127  5126  5125  5124  5123  5122  5121  5120  5119  5118  5117  5116  5115  5114  5113  5112  5111  5110  5109  5108  5107  5106  5105  5104  5103  5102  5101  5100  5099  5098  5097  5096  5095  5094  5093  5092  5091  5090  5089  5088  5087  5086  5085  5084  5083  5082  5081  5080  5079  5078  5077  5076  5075  5074  5073  5072  5071  5070  5069  5068  5067  5066  5065  5064  5063  5062  5061  5060  5059  5058  5057  5056  5055  5054  5053  5052  5051  5050  5049  5048  5047  5046  5045  5044  5043  5042  5041  5040
    5016  5015  5014  5013  5012  5011  5010  5009  5008  5007  5006  5005  5004  5003  5002  5001  5000  4999  4998  4997  4996  4995  4994  4993  4992  4991  4990  4989  4988  4987  4986  4985  4984  4983  4982  4981  4980  4979  4978  4977  4976  4975  4974  4973  4972  4971  4970  4969  4968  4967  4966  4965  4964  4963  4962  4961  4960  4959  4958  4957  4956  4955  4954  4953  4952  4951  4950  4949  4948  4947  4946  4945  4944  4943  4942 
}

asia = { 5824  5821  5810  5809  5808  5807  5806  5805  5804  5803  5802  5801  5800  5799  5798  5797  5796  5795  5794  5793  5785  5618  5784  5783  5782  5781  5780  5779  5778  5777  5776  5775  5774  5773  5772  5771  5770  5769  5768  5767  5766  5765  5764  5763  5762  5761  5760  5759  5758  5757  5756  5624  5755  5754  5753  5752  5751  5750  5749  5748  5747  5746  5745  5744  5743  5742  5741  5740  5739  5601  5738  5737  5736  5735  5596  5734  5733  5203  5732  5731  5730  5729  5728  5727  5726  5725  5724  5722  5721  5720  5719  5718  5717  5716  5715  5714  5190  5713  5712  5711  5710  5709  5708  5707  5706  5705  5704  5703  5702  5701  5700  5699  5698  5697  5696  5695  5694  5693  5692  5691  5690  5689  5688  5687  5686  5685  5684  5683  5682  5681  5680  5679  5678  5677  5676  5675  5674  5673  5672  5671  5670  5669  5668  5667  5666  5665  5664  5663  5662  5661  5660  5659  5658  5657  5656  5655  5654  5653  5584  5583  5582  5581  5580  5579  5578  5577  5576  5575  5574  5573  5572  5571  5570  5569  5568  5567  5566  5565  5564  5563  5562  5561  5560  5559  5558  
	5542  5541  5540  5539  5538  5537  5536  5535  5534  5533  5532  5531  5530  5529  5528  5527  5526  5525  5524  5523  5522  5521  5520  5519  5518  5517  5516  5515  5621  5626
	5514  5513  5512  5511  5510  5509  5508  5507  5506  5505  5504  5503  5502  5501  5500  5499  5498  5497  5496  5495  5494  5493  5492  5491  5490  5489  5488  5487  5622  5608
	5486  5485  5484  5483  5482  5481  5480  5479  5478  5477  5476  5475  5474  5473  5472  5471  5470  5469   5358  5357  5356  5355  5354  5353  5352  5351  5350  5349  5623  5607 5723 
	5348  5347  5346  5345  5344  5343  5342  5341  5340  5339  5338  5337  5336  5335  5334  5333  5332  5331  5330  5329  5328  5327  5326  5325  5324  5323  5322  5321  5320
	5319  5318  5317  5316  5315  5314  5313  5312  5311  5310  5309  5308  5307  5306  5305  5304  5303  5302  5301  5300  5299  5298  5297  5296  5295  5294  5293  5292  5291
	5290  5289  5288  5287  5286  5285  5284  5283  5282  5281  5280  5279  5278  5277  5276  5275  5274  5637
	5273  5272  5271  5270  5269  5268  5267  5266  5265  5264  5263  5262  5261  5260  5259  5258  5257  5256  5255  5254  5253
	5039  5038  5037  5036  5035  5034  5033  5032  5031  5030  5029  5028  5027  5026  5025  5024  5023  5022  5021  5020  5019  5018  5017 5244 
	5628
}

africa = {
}

north_america = {
}

south_america = {
}

oceania = {
}

island_check_provinces = {
}

# Used for RNW
new_world = {
}